Rodentes es un ordina de la mamales. La nom sinifia "los ci rode" en latina.
Ordina Rodentes

Suordina Sciuromorfo
Familia Aplodontido: castor de montania
Familia Sciurido: scural, tamia, can de prado
Familia Glirido: liron
Suordina Castorimorfo
Suprafamilia Castoroideo
Familia Castorido: castor
Suprafamilia Jeomioideo
Familia Eteromido: rata cangarin, mus cangarin
Familia Jeomido: gofer
Suordina Miomorfo
Suprafamilia Dipodoideo
Familia Dipodido: jerboa e mus saltante
Suprafamilia Muroido
Familia Platacantomido: liron spinosa
Familia Spalacido: rata de bambu
Familia Calomiscido: mus cricetin
Familia Nesomido: mus de rocas
Familia Cricetido: criceto
Familia Murido: mus, rata
Suordina Anomaluromorfo
Familia Anomalurido: anomalures
Familia Pedetido: lepre saltante
Suordina Istricomorfo
Familia incertae sedis Diatomido: rata de rocas lao
Infraordina Ctenodatilomorfo
Familia Ctenodatilido: gundi
Infraordina Istricognatio
Familia Istricido: porcospina tera vea (porcospina)
Familia Eretizontido: porcospina de tera nova (porcospina)
Familia Trionomido: aulacode
Familia Petromurido: rata de rocas
Familia Batiergido: rata talpin
Parvordina Caviomorfo
Familia Octodontido: octodonte
Familia Ecimido: rata spinosa
Familia Capromido: utia
Familia â€ Eptaxodontido: utia grande
Familia Miocastorido: lutra
Familia Dasiproctido: aguti
Familia Dinomido: pacarana
Familia Cavido: cavia
Familia Idrocerido: capibara
Familia Xinxilido: xinxila
Familia Abrocomido: rata xinxilin
Familia Ctenomido: tucotuco