Pharansiya aru (langue française); kastilla aru: idioma francés Iwrupa aru, xeramanu aru.

Phransiya
Bélgica
Suysa

Uno: un /œ̃/
Dos: deux /dø/
Tres: trois /tʁwa/
Cuatro: quatre /katʁ/
Cinco: cinq /sɛ̃k/
Seis: six /sis/
Siete: sept /sɛt/
Ocho: huit /ʔɥɪt/
Nueve: neuf /nœf/
Diez: dix /dis/
Once: onze /ɔ̃z/
Doce: douze /duz/
Trece: treize /tʁɛz/
Catorce: quatorze /katɔʁz/
Quince: quinze /kɛ̃z/
Dieciséis: seize /sɛz/
Diecisiete: dix-sept /dis.sɛt/
Dieciocho: dix-huit /di.z‿ɥit/
Diecinueve: dix-neuf /diz.nœf/
Veinte: vingt /vɛ̃/
Veintiuno: vingt-et-un
Veintidós: vingt-deux
Veintitrés: vingt-trois
30.  Treinta: trente
40.  Cuarenta: quarante
50.  Cincuenta: cinquante
60.  Sesenta: soixante
70.  Setenta: soixante-dix
80.  Ochenta: quatre-vingt
90.  Noventa: quatre-vingt-dix


== Links ==
Learn French Online
Académie française (Phransiya aru).
Office québécois de la langue française (Phransiya aru).
ParisByPod Podcast - donde se puede escuchar una lista de verbos en mp3 (en inglés).
Organización Internacional de la Francofonía (Phransiya aru).
Informe de Ethnologue sobre el francés (Inlish aru).
Ejercicios de francés (Dr. Etienne Meul) (Phransiya aru).
Traductores automáticos de francés: Traductores automáticos y diccionarios de francés a español y de español a francés, y recursos sobre el idioma francés.
The French Tutorial: una lección en Internet que enseña los básicos paso a paso.
Conjugación de verbos en Francés (Phransiya aru).
Le Point du FLE Acceso a las mejores actividades para el estudio del francés en Internet.
Ortotipografía comparada (Phransiya aru-kastilla aru) [PDF].
Diccionarios de francés Recopilación de diccionarios de francés.
IFAL (Instituto Francés de América Latina en México) (Phransiya aru).
Aprender francés con ejercicios de fonética (Phransiya aru).
Aprender llevando a cabo una investigación policíaca
Léxico de francès (Phransiya aru)
Diccionario Freelang Diccionario francés-español/Kastilla aru-Phransiya aru.
Aprende Phransiya aru Recursos para el aprendizaje del francés: pronunciación, vocabulario, conjugación y gramática.