Ikigereki cyangwa Ikigiriki (izina mu kigereki : ελληνική γλώσσα ) ni ururimi rw’Ubugereki na Shipure. Itegekongenga ISO 639-3 ell (indimi: grc, pnt,...).


== Alfabeti y’kigereki ==
Igifero kigizwe n’inyuguti 24 : α β γ δ ε ζ η θ ι κ λ μ ν ξ ο π ρ σ (ς) τ υ φ χ ψ ω

inyajwi 7 : α ε η ι ο υ ω
indagi 17 : β γ δ ζ θ κ λ μ ν ξ π ρ σ (ς) τ φ χ ψ


== Amagambo n’interuro mu kigereki ==
Χαίρεται – Muraho
Πώς είστε; – Amakuru?
Πολύ καλά – Ni meza
Ναι – Yego
Όχι – Oya
Με λένε ...  – Nitwa ...
άνθρωπος – umuntu
άνδρας – umugabo
γυναίκα – umugore
ζώο – inyamaswa
φυτό cyangwa φυτεύω – ikimera
σκύλος – imbwa
πουλί – inyoni
ψάρι – ifi
γάτα – ipusi
φίδι – inzoka
άλογο – ifarashi
κότα – inkoko
δέντρο – igiti
καρπός – imbuto


== Imibare ==
ἒνα cyangwa ένα – rimwe
δύο – kabiri
τρία – gatatu
τέσσερα – kane
πέντε – gatanu
ἓξι cyangwa έξι – gatandatu
ἑπτά cyangwa εφτά – karindwi
ὀκτώ cyangwa οχτώ – umunani
ἐννέα cyangwa εννιά – icyenda
δέκα – icyumi