De Portugeesche Spraak (portugeesch portugues) is de natschonale Spraak vun Portugal, un de offizielle Spraak vun Brasilien, Angola un annere Staten, de fröher in portugeesche Kolonien weren. In de indische Stadt Goa warrt de Spraak ok noch spraken, man nich anerkind. Dat Portugeesch geiht bi de Noordgrenz vun Portugal över in’t Galizisch, dat de spaansche Överheid as anner Spraak gellen laat. Dat Portugeesch hett 200.000.000 Sprekers un is dormit de föfft- oder sösstgröttste Weltspraak. Circa 2,5 Millioonen Lüüd in de USA, sünners in New Jersey, Massachusetts, Rhode Island un Kalifornien snackt disse Spraak.
Dat Portugeesch höört to de Grupp vun ibero-romaansche Spraken un is eng verbunnen mit't Spaansche. De Spraak is in’t 9. Johrhunnert för’t ierst opschreven. De Dialekt-Variatschoon is ring, ok twüschen de Länner: Dat Portugeesch in Brasilien un’t europääsche Portugeesch verholln sik as’t britisch Engelsch un't amerikaansche Engelsch.


== Mehrste Dialekten un Kategorien ==


=== Portugal ===
Açoriano - Azoren
Alentejano - Alentejo
Algarvio - Algarve
Alto-Minhoto - Braga 
Baixo-Beirão; Alto-Alentejano - zentraal Portugal
Beirão - zentraal Portugal
Estremenho - Coimbra, Lisboa un anner Öört
Madeirense - Madeira
Nortenho - Braga, Porto un Öört
Transmontano - Trás-os-Montes


=== Brasilien ===
Caipira - inner Deel vun de Staat São Paulo, Paraná un Söden vun Minas Gerais
Cearense - Ceará
Baiano - Region Bahia
Fluminense - Staten Rio de Janeiro un Espírito Santo
Gaúcho - Rio Grande do Sul
Mineiro - Minas Gerais
Nordestino - Recife u. a.
Nortista - Amazonas-Becken
Paulistano - São Paulo
Sertão - Staten Goiás un Mato Grosso
Sulista - Staten Paraná un Santa Catarina


=== Angola ===
Benguelense - Provinz Benguela
Luandense - Provinz Luanda
Sulista - Söden vun Angola


=== Anner Länner ===
Caboverdiano - Cabo Verde
Guineense - Guinea-Bissau|Guinéa-Bissau
Macaense - Macau, China
Moçambicano - Moçambique
Santomense - São Tomé e Principe
Timorense - Osttimor


== Weblenke ==

Comunidade dos Países de Lingua Portuguesa
Düütsche Lusitanistik