Avia es un grupo de vertebratos distingui per ave plumas, beco, produi ovos poneda par la fema, cor de cuatro partes e un sceleto forte ma lejera.
Esta es un lista de la ordinas en la clase Avia:
Paleognato

Strutioniformo - astruzo, emu, casuari, rea, ciui
Tinamiformo - tinamo
Neognato

Anseriformo - pato, ganso, sinie
Galiformo - gal, pavo, pavon
Gaviformo - gavia
Podisipediformo - grebe
Proselariformo - albatros
Sfenisiformo - pinguin
Pelecaniformo - pelican, bobo
Siconiformo - siconia
Fenicopteriformo - flamingo
Falconiformo - agila, falcon
Gruiformo - gru
Caradriformo - caradrio
Pteroclidiformo - ganga
Columbiformo - pijon
Psitasiformo - papagaio, cacatu
Cuculiformo - cucu
Strijiformo - bu tito
Caprimuljiformo - caprimuljo
Apodiformo - venseo
Trociliformo - colibri
Corasiformo - pexor cucabura
Piciformo - picor
Trogoniformo - cetsal trogon
Coliformo - colio
Paseriformo - pasaro
Vide ance: Ovo