Primata iku anggota saka ordo biologi, grup iki dumadi saka kabèh lemur, kethèk, lan manungsa. Primata asal saka tembung Latin Primates, kang tegesé "salah siji kang pisanan, paling apik, noble". Colin Groves ndata watara 350 spésies primata sajeroning Primate Taxonomy. Èlmu kang nyinaoni primata dijenengaké primatologi. Kabèh primata duwé limang driji (pentadactyly), wangun untu kang umum lan rencana awak primitif (ora spesial). Prabédan liya saka primata yakuwi kuku driji. Kabèh primata, mala kang ora duwé sipat kang biyasa saka primata liyané (kaya loris), duwé karakteristik orbit mata kang mbédakaké saka order taksonomi liyané. Karakter primata antarané pandangan kang duwé sipat stereoskopik (binocular vission), postur awak tegak.


== Klasifikasi primata ==
Ing ngisor iki pratélan warna-warna famili primata: 

Order Primates
Suborder Strepsirrhini: non-tarsier prosimians
Infraorder Lemuriformes
Famili Cheirogaleidae: lemur kurcaci lan lemur tikus (32 species)
Famili Daubentoniidae: Aye-aye (1 species)
Famili Lemuridae: lemurs (22 species)
Famili Lepilemuridae: sportive lemur (26 species)
Famili Indriidae: woolly lemurs lan allies (19 species)
Infraorder Lorisiformes
Famili Lorisidae: lorises, pottos lan allies (9 species)
Famili Galagidae: galagos (19 species)
Suborder Haplorrhini: tarsiers, monkeys lan apes
Infraorder Tarsiiformes
Famili Tarsiidae: tarsiers (9 species)
Infraorder Simiiformes
Parvorder Platyrrhini: New World monkeys
Famili Callitrichidae: marmosets lan tamarins (42 species)
Famili Cebidae: capuchins lan squirrel monkeys (17 species)
Famili Aotidae: kethèk wengi utawa kethèk beluk (douroucoulis) (10 species)
Famili Pitheciidae: titis, sakis lan uakaris (42 species)
Famili Atelidae: howler, spider lan kethèk wulu (28 species)
Parvorder Catarrhini
Superfamili Cercopithecoidea
Famili Cercopithecidae: Old World monkeys (135 species)
Superfamili Hominoidea
Famili Hylobatidae: gibbons utawa "lesser apes" (13 species)
Famili Hominidae: great apes (7 species)