Ежӹнгӓн яланвлӓ (латинлӓ Arthropoda) — Ecdysozoa группыш пырышы ялвлӓштӹ ежӹнгӓн икманяр кого, шукы изи тупӹрдӹдӹмӹ йӓнвлӓ. Цилӓжӹ 1 170 000 тӹрлӹ ежӹнгӓн ялан улы. 
Лӹмӹн этимологижӹ тошты грек «ἄρθρον» (ежӹнг) дон «ποδός» (ял) шамаквлӓ гӹц лин.


== Классификаци ==
Arachnomorpha — Ӓнгӹремшӹвлӓ дон трилобитвлӓ
Trilobitomorpha — Трилобит ганьывлӓ
Trilobita — Трилобитвлӓ
Chelicerata — Хелицерӓнвлӓ
Pantopoda — Тангыж ӓнгӹремшӹвлӓ
Arachnida — Ӓнгӹремшӹ ганьывлӓ
Merostomata — Меростомовые (мечехвосты)
Gigantostraca † — Эвриптериды (гигантские морские скорпионы)
Mandibulata — Жвалоносные
Crustacea — Рӓк ганьывлӓ
Remipedia — Ремипедивлӓ
Cephalocarida — Цефалокаридвлӓ
Branchiopoda — Жаброногие
Ostracoda — Ракушковые
Mystacocarida — Мистакокаридвлӓ
Maxillopoda — Максиллоподвлӓ
Branchiura — Карпоеды
Malacostraca —  Высшие раки
Atelocerata —  Неполноусые, или трахейные
Myriapoda — Шукы яланвлӓ
Symphyla — Симфилы
Chilopoda — Губоногие
Diplopoda — Двупарноногие
Pauropoda — Пауроподы
Insecta — Капшангывлӓ
Entognatha — Скрыточелюстные
Ectognatha —  Открыточелюстные