Brasil, ofisialmente Repúblika Federativo di Brasil, ta e país mas grandi di tanto Sur Amérika komo Latino Amérika. E tin frontera ku Guyana Franses, Guyana, Sürnam, Venezuela, Colombia, Peru, Bolivia, Paraguai, Argentina i e Oséano Atlántiko. Kapital di Brasil ta Brasília i e siudatnan mas grandi ta São Paulo i Rio de Janeiro. Brasil su superfisie ta enorme i e pais su poblashon ta hopi grandi tambe. Brasil tin 26 siudat i e distrikto federal unda e kapital Brasília ta situá.
E lenga materno di e poblashon ta e Portugues.
E desaroyo di e pais ta hopi grandi tambe.


==== Estadonan den Brasil i nan kapital ====
Acre - Rio Branco
Alagoas - Maceió
Amapá - Macapá
Amazonas - Manaus
Bahia - Salvador
Ceará - Fortaleza
Espírito Santo - Vitória
Goiás - Goiania
Maranhão - São Luís
Mato Grosso - Cuiabá
Mato Grosso do Sul - Campo Grande
Minas Gerais - Belo Horizonte
Pará - Belém
Paraiba - João Pessoa
Paraná - Curitiba
Pernambuco - Recife
Piauí - Teresina
Rio Grande do Norte - Natal
Rio Grande do Sul - Porto Alegre
Rio de Janeiro - Rio de Janeiro
Rondonia - Porto Velho
Roraima - Boa Vista
Santa Catarina - Florianópolis
São Paulo - São Paulo
Sergipe - Aracajú
Tocantins - Palmas