Dram ialah alat muzik seperti gendang yang dipasangi belulang pada satu atau kedua-dua hujungnya dan dimainkan dengan mengetuknya dengan tangan atau kayu dram,Dram juga biasanya digunakan oleh ahli-ahli muzik berkumpulan.


== Pemain Dram tersohor malaysia ==

Pemain dram di bawah tidak diiktiraf kecuali memiliki rujukan pihak yang mengesahkan mereka sebagai pemain dram terbaik (melalui anugerah/kejuaraan) oleh pihak yang diiktiraf. Anugerah facebook tidak diterima.
Man Dayak - Kumpulan Lefthanded
Yazit - Kumpulan Search
Black - Kumpulan Wings, Malaysia kumpulan Gamma, Strangers/Lefthanded & Kumpulan Babylon)
Lee Space - Kumpulan XPDC/Def-Geb-C
Allahyarham Syed Noor Eduat - Kumpulan SYJ
Nahar - Kumpulan Sofea
Jojet - Kumpulan Gersang/Wings
A.J - Kumpulan Lipan Bara
Irman Masrom - Kumpulan Rockers
E'Poll - Kumpulan Masa
Amy - Kumpulan XPDC/Kamikaze/Viper/Handy Black
Man - Kumpulan May
Ujang - Kumpulan Exist/Amuk
Lola Saiful Rizla - Kumpulan Saga, Crossfire, XPDC, Kamikaze (kugiran), Search
Zam - Kumpulan FTG
Miji - Kumpulan Cromok
Emy Syahmi - Massacre Conspiracy
Enal - BPR
Kama - Iklim
Karim - Blues Gang
Razak - Headwind
Shuib - Freedom
Pa'e - Barongan,XPDC,M-Pire,Projek Pistol
Ringgo - Kumpulan Fotograf
Atong - Kumpulan Def Geb C
Azizan - Kumpulan Rusty Blade
Jatt - Kumpulan Black Dog Bone
Tom - Kumpulan Headwind/Lefthanded
Shahrin - Kumpulan Blackrose
Acap - Kumpulan Kristal
Bakri - Kumpulan Gerhana Ska Cinta/Flop Poppy/Meet Uncle Husin/Azlan& Typewriter
Kamal - Kumpulan Ekamatra
Ayie - Kumpulan Spider
Rano - Kumpulan U-Thopia

Jika anda melihat rencana yang menggunakan templat {{tunas}} ini, gantikanlah dengan templat tunas yang lebih spesifik.