Swahilia o Kiswahili esas bantua linguo parolata da diversa etniala grupi qui vivas proxim la kanalo di Mozambik, inkluzite en Komori. Olu esas oficala linguo en 4 landi: Kenia, Uganda, Tanzania e Komori, ed ank en Afrikana Uniono. Granda parto di lua vortaro originis de Araba linguo, e skribesas maxim ofte per la latina alfabeto, ma ank aceptesas skribar ol per araba alfabeto.


== Vortaro ==


=== Animali ===
jogoo: hano
simba: leono
mbuzi: kapro
panya: muso
tembo: elefanto
kiboko: hipop√≥tamo
chui: leopardo
farasi: Kavalo
mbwa: hundo
paka: kato
dubu: urso
bata: anado


=== Kolori ===
nyeupe: Blanka
nyeusi: Nigra
blu: Blua
nyekundu : Reda
manjano : Flava
kijani : Verda


=== Nombri ===
sifuri : Zero
moja : Un
mbili : Du
tatu : Tri
nne : quar
tano  : Kin
sita : Sis
saba : Sep
nane : Ok
tisa : Non
kumi : Dek
kumi na moja : Dek-e-un
ishihirini : Duadek


=== Monati ===
januari: Januaro
februari: Februaro
machi: Marto
aprili: Aprilo
mei: Mayo
juni: junio
julai: julio
agostai: Agosto
septemba: Septembro
octoba: Oktobro
novemba: Novembro
desemba: Decembro


== Exemplo ==
Yen Patro nia en Ido e Swahilia (Baba yetu):


== Referi ==


== Extera ligilo ==
Kamusi Project Internet Living Swahili Dictionary